1111111111111111111111
1EC000000000000C000C01
1010010100100000101001
1P10010010101010001001
100000000C00C000000001
1111111111111111111111
1111111111111111111111
