111111111111111111
10C10000000C000001
100001111100000C01
1P0011E0000C000001
111111111111111111