1111111111111
10C10000000C1
1000011111001
1P0011E0000C1
1111111111111

struct t_point
{
	int x; //horizental
	int y; // vertical
};


