1111111111111111111111
1EC000000000000C000C01
1010010100100000101001
1010010010101010001001
1P0000000C00C000000001
1111111111111111111111
1111111111111111111111