1111111111111111111111
1E0000000000000C000C01
1010010100100000111001
1010010010101N10001001
1P0000000C00C0000NN001
1111111111111111111111