1111111111111111111111
1E00N000000N000C000C01
1010010100100000111001
1010010010101010001001
1P0N00000C00C000000001
1111111111111111111111